00000000000041000000000000000000
00000000000052000000000000000000
00000000000052000000000000000000
00000000000052000000000000000000
00000000000052222200000000000000
00000000000055555200000000000000
00000000000000005200000000000000
00000000000000005200000000000000
00000000000000005200000000000000
00000000000000005200000000000000
00000000000000005200000000000000
00000000000000005200000000000000
00000000000000005200000000000000
00000000000000005200000000000000
00000000000000005200000000000000
00000000000000005200000000000000
00000000000055555200000000000000
00000000000052222200000000000000
00000000000052000000000000000000
00000000000052000000000000000000
00000000000052000000000000000000
00000000000052000000000000000000
00000000000052000000000000000000
00000000000063000000000000000000