00000000000041000000000000000000
00000000000052000000222222200000
00000000000052000000255555200000
00000000000052000000250005200000
00000000000052222222250005200000
00000000000055555555550005200000
00000000000000000000000005200000
00000000000000000000000005200000
00000000000000000000000005200000
00000000000000000000000005200000
00000000000000005555555555200000
00000000000000005222222222200000
00000000000000005200000000000000
00000000000000005200000000000000
00000000000000005200000000000000
00000000000000005200000000000000
00000000000055555200000000000000
00000000000052222200000000000000
00000000000052000000000000000000
00000000000052000000000000000000
00000000000052000000000000000000
00000000000052000000000000000000
00000000000052000000000000000000
00000000000063000000000000000000