00000000000041000000000000000000
00000000000052000000000000000000
00000000000052000000000000000000
00000000000052000000000000000000
00000000000052000000000000000000
00000000000052000000000000000000
00000000000052000000000000000000
00000000000052000000000000000000
00000000000052000000000000000000
00000000000052000000000000000000
00000000000052000000000000000000
00000000000052000000000000000000
00000000000052000000000000000000
00000000000052000000000000000000
00000000000052000000000000000000
00000000000052000000000000000000
00000000000052000000000000000000
00000000000052222222222222200000
00000000000055555555555555200000
00000000000000000000000005200000
00000000000000055555555555200000
00000000000000052222222222200000
00000000000000052000000000000000
00000000000000063000000000000000