04100000000000000000000000000000
05200000000000000000000000000000
05200000000000000000000000000000
05222220000000022222200000000000
05555520000000025555200000000000
00000520000000025005200000000000
00000520000000025005200000000000
00555520000000025005200000000000
00522220000000025005200000000000
00520000000000025005200000000000
00520000000000025005200000000000
00522222222222225005222222200000
00555555555555555005555555200000
00000000000000000000000005200000
00000000000000000000000005200000
00000000000000000000000005200000
00000000000000000000000005200000
00000000000000000000000005200000
00000000000000000000000005222220
00000000000000000000000005555520
00000000000000000000000000000520
00000000000000000000000000000520
00000000000000000000000000000520
00000000000000000000000000000630