00000000000000410000000000000000
00000000000000520000000000000000
00000000000000520000000000000000
00000000000000520000000000000000
00000000000000520000000000000000
00000000000000520000000000000000
00000000000000520000000000000000
00000000000000520000000000000000
00000000000000520000000000000000
00000000000000520000000000000000
00000000000000520000000000000000
00000000000000520000000000000000
00000000000000520000000000000000
00000000000000520000000000000000
00000000000000520000000000000000
00000000000000520000000000000000
00000000000000520000000000000000
00000000000000520000000000000000
00000000000000520000000000000000
00000000000000520000000000000000
00000000000000520000000000000000
00000000000000520000000000000000
00000000000000520000000000000000
00000000000000630000000000000000
