00000000000000000000000000004100
00000000005555555555555555555200
00000000005222222222222222222200
00000000005200000000000000000000
00000000005222000000000000000000
00000000005552000000000000000000
00000000000052222222220000000000
00000000000055555555520000000000
00000000000000000000520000000000
00000000000000000000520000000000
00000000000000000000520000000000
00000000000000000000522222000000
00000000000000000000555552000000
00000000000000000000000052000000
00000000000000000000000052000000
00000000000000000000000052000000
00000000000000000000000052000000
00000000000000000000000052000000
00000000000000000000000052000000
00000000000000000000555552000000
00000000000000000000522222000000
00000000000000000000520000000000
00000000000000000000520000000000
00000000000000000000630000000000
